Country,Boot,Steuermann,Vorschoter,Club,Race1,Race2,Race3,Points,Place
AUS,8817,Nick Davis,Michael Duffield,,5,4,10,19,1
GER,8992,Claas Lehmann,Leon Oehme,NRV,8,12,5,25,2
USA,8762,Howie Hamlin,Andy Zinn,,16,10,4,30,3
AUS,9018,Robin Duessen,Jordan Spencer,,9,16,8,33,4
USA,8878,Ted Conrads,Brian Haines,,25,8,2,35,5
AUS,8946,Sandy Higgins,Paul Marsh,,15,7,14,36,6
AUS,9036,Michael Quirk,Sam Heritage,,18,1,18,37,7
HKG,9055,Mark Thornburrow,Laurence Mead,,19,13,7,39,8
GER,9027,Wolfgang Hunger,Julien Kleiner,PYC,1,27,12,40,9
USA,9002,Mike Holt,Carl Smit,,6,2,33,41,10
GBR,9032,Ian Pinnel,Charles Dwyer,,2,25,17,44,11
USA,8681,Ryan Cox,Stu Park,,14,34,6,54,12
USA,8714,Mike Martin,Geoff Ewenson,,3,9,50,62,13
GBR,9006,Terry Scutcher,Christian Diebitsch,,13,39,11,63,14
GBR,9056,Luke Molloy,Jim Turner,,22,17,24,63,15
AUS,8783,Michael Thomson,Marcus Cooper,,39,6,20,65,16
AUS,8922,Bill Cuneo,John Warlow,,7,37,22,66,17
GER,9028,Stefan Köchlin,Thomas Jung,SKF,4,33,30,67,18
AUS,8973,Brett Sharpe,Anthony Gaunt,,21,42,13,76,19
AUS,8890,Malcolm Higgins,Andrew Chisholm,,35,3,40,78,20
GER,9043,Nicola Birkner,Angela Stenger,SVaW,31,49,1,81,21
AUS,8957,Kevin Cameron,Josh Mortensen,,26,41,15,82,22
USA,8831,Paul Von,Doug Hagen,,30,19,34,83,23
AUS,8893,Ryan Menzies,Joel Castle,,32,22,35,89,24
AUS,8840,Shane Guanaria,Leigh Riddell,,42,32,16,90,25
FRA,9010,Xavier Broise,Gilles Carvallo,,50,11,32,93,26
AUS,8626,Nathan Outteridge,Iain Jensen,,41,28,27,96,27
AUS,8877,Daniel Keys,Darryl Roos,,52,21,25,98,28
AUS,8801,Peter Chappell,Matt Smith,,23,15,61,99,29
USA,9009,Bruce Edwards,Mathias Kennerknecht,,27,29,43,99,30
AUS,8523,Ayden Menzies,Lachlan Hornsby,,38,20,44,102,31
GER,8875,Jens Findel,Johannes Tellen,,11,5,88,104,32
AUS,8781,Earle Alexander,Ian Gregg,RQYS,44,18,47,109,33
USA,8792,Carol Buchan,Carl Buchan,,51,58,3,112,34
AUS,9037,Nigel Lott,Bob Franks,RQYS,63,31,19,113,35
AUS,8796,Nicholas Deussen,Jonno Bannister,,36,43,36,115,36
GER,9040,Meike Schomäker,Holger Jess,ZSK,20,14,88,122,37
GER,9000,Enno Wilts,Klaus Heeschen,SVBB,55,36,32,123,38
FRA,8683,Antoine Lafortune,Geraud Lafortune,CVSP,57,46,21,124,39
AUS,8797,Peter Nicolas,Luke Payne,,33,47,45,125,40
AUS,8759,Steve McConaghy,Nick Johnstone,,54,53,23,130,41
DEN,8964,Jan Saugmann,Morten Ramsbaek,HiS,17,88,26,131,42
CAN,8970,Bob Tennant,Rich Mundell,,40,45,47,132,43
AUS,8794,Mick Babbage,James McAllister,,12,35,88,135,44
FRA,9050,Herve Dekegariou,Bernadette de Kergariou,,64,64,9,137,45
SWE,8926,Ebbe Rosén,Olle Wenrup,,24,26,88,138,46
AUS,8864,Ed Cox,Cameron McDonald,,46,30,62,138,47
AUS,8644,Brett Beyer,Darren Gilbert,,28,24,88,140,48
AUS,8637,Sam Cronin,Kevin Whitbread,,53,51,36,140,49
GBR,8945,Roger Deane,Adam Kenney,,45,44,54,143,50
DEN,8958,Nikolaj Buhl,Henrik Buhl,,29,88,29,146,51
USA,8084,Aaron Ross,Rob Waterman,,49,50,51,150,52
GER,8777,Stefan Schollmayer,Francisco Sanguino,SCMSP,56,60,37,153,53
AUS,9022,Ian Burford,Dave Christie,,58,56,41,155,54
AUS,8920,Jeff Robinson,Neville Kerr,,47,54,56,157,55
AUS,8886,John Paterson,Paul Greenwood,,62,59,39,160,56
AUS,8853,Carter Jackson,Peter Holden,MHYC,10,88,63,161,57
USA,7875,Jeff Miller,Mike Smith,,37,40,88,165,58
CAN,8192,Philip Cragg,Reto Corfu,,48,57,64,169,59
USA,8904,Hubert Guy,Xavier Detappe,,34,52,88,174,60
USA,8960,Bruce Vandeventer,Scott Weiler,,65,65,49,179,61
AUS,8498,Jonathan Ross,Ian Scholes,,67,66,48,181,62
GER,9029,Jürgen Waldheim,Jan-Rolf Schmidt,PYC,43,88,52,183,63
GER,9054,Helen Fischer,Lars Dehne,BYC,59,38,88,185,64
AUS,8628,Peter Croft,Gary Rushton,,60,88,46,194,65
AUS,8185,Nathan Rosenberg,Reeve Dunne,,66,63,66,195,66
AUS,8894,Paul Mitchell,Sam Haines,WSC,88,48,60,196,67
AUS,6819,Ian Taylor,Robin Bath,,88,55,53,196,68
AUS,8638,Claus Ejlertsen,Mick Patrick,,88,23,88,199,69
AUS,8891,Sarah Withall,Robert Gilchrist,,68,67,68,203,70
AUS,8739,John McLean,Dennis Winstanley,,88,62,59,209,71
AUS,8710,Brett Bowden,Bradley Greenrod,,61,61,88,210,72
GER,7206,Christian Pittack,Annie Fitzpatrick,SCLW,88,68,55,211,73
AUS,8554,AJ Crane,David Parker,,88,88,38,214,74
AUS,8784,Gilbert Ford,James Ford,,88,69,58,215,75
AUS,8221,Luke Rhodes,Andrew McCole,,88,88,57,233,76
AUS,8639,Grahame Tindell,David Johnson,,88,88,65,241,77
AUS,8038,Adrian Kiely,Darren Cooney,,88,88,67,243,78
